0,0,0,0,0,*,*,0,0,0,0,0,0,0,0,0,0,0,0,0,0,0,0,*,*,0,0,0,0,0,0,0,0,0,0,0,0,0,0,0,0,*,*,0,0,0,0,0,0,0,0,0,0,0,0,0,0,0,0,*,*,0,0,0,0,0
0,0,0,0,0,*,*,0,0,0,0,0,0,0,0,0,0,0,0,0,0,0,0,*,*,0,0,0,0,0,0,0,0,0,0,0,0,0,0,0,0,*,*,0,0,0,0,0,0,0,0,0,0,0,0,0,0,0,0,*,*,0,0,0,0,0
0,0,0,0,0,1,1,0,0,0,0,2,2,0,0,0,0,3,3,0,0,0,0,4,4,0,0,0,0,5,5,0,0,0,0,6,6,0,0,0,0,7,7,0,0,0,0,8,8,0,0,0,0,9,9,0,0,0,0,a,a,0,0,0,0,0
0,0,0,0,0,1,1,0,0,0,0,2,2,0,0,0,0,3,3,0,0,0,0,4,4,0,0,0,0,5,5,0,0,0,0,6,6,0,0,0,0,7,7,0,0,0,0,8,8,0,0,0,0,9,9,0,0,0,0,a,a,0,0,0,0,0
0,0,0,0,0,1,1,0,0,0,0,2,2,0,0,0,0,3,3,0,0,0,0,4,4,0,0,0,0,5,5,0,0,0,0,6,6,0,0,0,0,7,7,0,0,0,0,8,8,0,0,0,0,9,9,0,0,0,0,a,a,0,0,0,0,0
0,0,0,0,0,1,1,0,0,0,0,2,2,0,0,0,0,3,3,0,0,0,0,4,4,0,0,0,0,5,5,0,0,0,0,6,6,0,0,0,0,7,7,0,0,0,0,8,8,0,0,0,0,9,9,0,0,0,0,a,a,0,0,0,0,0
0,0,0,0,0,1,1,0,0,0,0,2,2,0,0,0,0,3,3,0,0,0,0,4,4,0,0,0,0,5,5,0,0,0,0,6,6,0,0,0,0,7,7,0,0,0,0,8,8,0,0,0,0,9,9,0,0,0,0,a,a,0,0,0,0,0
0,0,0,0,0,1,1,0,0,0,0,2,2,0,0,0,0,3,3,0,0,0,0,4,4,0,0,0,0,5,5,0,0,0,0,6,6,0,0,0,0,7,7,0,0,0,0,8,8,0,0,0,0,9,9,0,0,0,0,a,a,0,0,0,0,0
0,0,0,0,0,1,1,0,0,0,0,2,2,0,0,0,0,3,3,0,0,0,0,4,4,0,0,0,0,5,5,0,0,0,0,6,6,0,0,0,0,7,7,0,0,0,0,8,8,0,0,0,0,9,9,0,0,0,0,a,a,0,0,0,0,0
0,0,0,0,0,1,1,0,0,0,0,2,2,0,0,0,0,3,3,0,0,0,0,4,4,0,0,0,0,5,5,0,0,0,0,6,6,0,0,0,0,7,7,0,0,0,0,8,8,0,0,0,0,9,9,0,0,0,0,a,a,0,0,0,0,0
0,0,0,0,0,0,0,0,0,0,0,0,0,0,0,0,0,0,0,0,0,0,0,0,0,0,0,0,0,0,0,0,0,0,0,0,0,0,0,0,0,0,0,0,0,0,0,0,0,0,0,0,0,0,0,0,0,0,0,0,0,0,0,0,0,0
0,0,0,0,0,0,0,0,0,0,0,0,0,0,0,0,0,0,0,0,0,0,0,0,0,0,0,0,0,0,0,0,0,0,0,0,0,0,0,0,0,0,0,0,0,0,0,0,0,0,0,0,0,0,0,0,0,0,0,0,0,0,0,0,0,0
0,0,0,0,0,*,*,0,0,0,0,0,0,0,0,0,0,0,0,0,0,0,0,*,*,0,0,0,0,0,0,0,0,0,0,0,0,0,0,0,0,*,*,0,0,0,0,0,0,0,0,0,0,0,0,0,0,0,0,*,*,0,0,0,0,0
0,0,0,0,0,*,*,0,0,0,0,0,0,0,0,0,0,0,0,0,0,0,0,*,*,0,0,0,0,0,0,0,0,0,0,0,0,0,0,0,0,*,*,0,0,0,0,0,0,0,0,0,0,0,0,0,0,0,0,*,*,0,0,0,0,0
0,0,0,0,0,0,0,0,0,0,0,0,0,0,0,0,0,0,0,0,0,0,0,0,0,0,0,0,0,0,0,0,0,0,0,0,0,0,0,0,0,0,0,0,0,0,0,0,0,0,0,0,0,0,0,0,0,0,0,0,0,0,0,0,0,0
0,0,0,0,0,0,0,0,0,0,0,0,0,0,0,0,0,0,0,0,0,0,0,0,0,0,0,0,0,0,0,0,0,0,0,0,0,0,0,0,0,0,0,0,0,0,0,0,0,0,0,0,0,0,0,0,0,0,0,0,0,0,0,0,0,0
0,0,0,0,0,*,*,0,0,0,0,0,0,0,0,0,0,0,0,0,0,0,0,*,*,0,0,0,0,0,0,0,0,0,0,0,0,0,0,0,0,*,*,0,0,0,0,0,0,0,0,0,0,0,0,0,0,0,0,*,*,0,0,0,0,0
0,0,0,0,0,*,*,0,0,0,0,0,0,0,0,0,0,0,0,0,0,0,0,*,*,0,0,0,0,0,0,0,0,0,0,0,0,0,0,0,0,*,*,0,0,0,0,0,0,0,0,0,0,0,0,0,0,0,0,*,*,0,0,0,0,0
0,0,0,0,0,0,0,0,0,0,0,0,0,0,0,0,0,0,0,0,0,0,0,0,0,0,0,0,0,0,0,0,0,0,0,0,0,0,0,0,0,0,0,0,0,0,0,0,0,0,0,0,0,0,0,0,0,0,0,0,0,0,0,0,0,0
0,0,0,0,0,0,0,0,0,0,0,0,0,0,0,0,0,0,0,0,0,0,0,0,0,0,0,0,0,0,0,0,0,0,0,0,0,0,0,0,0,0,0,0,0,0,0,0,0,0,0,0,0,0,0,0,0,0,0,0,0,0,0,0,0,0
0,0,0,0,0,b,b,0,0,0,0,c,c,0,0,0,0,d,d,0,0,0,0,e,e,0,0,0,0,f,f,0,0,0,0,g,g,0,0,0,0,h,h,0,0,0,0,i,i,0,0,0,0,j,j,0,0,0,0,k,k,0,0,0,0,0
0,0,0,0,0,b,b,0,0,0,0,c,c,0,0,0,0,d,d,0,0,0,0,e,e,0,0,0,0,f,f,0,0,0,0,g,g,0,0,0,0,h,h,0,0,0,0,i,i,0,0,0,0,j,j,0,0,0,0,k,k,0,0,0,0,0
0,0,0,0,0,b,b,0,0,0,0,c,c,0,0,0,0,d,d,0,0,0,0,e,e,0,0,0,0,f,f,0,0,0,0,g,g,0,0,0,0,h,h,0,0,0,0,i,i,0,0,0,0,j,j,0,0,0,0,k,k,0,0,0,0,0
0,0,0,0,0,b,b,0,0,0,0,c,c,0,0,0,0,d,d,0,0,0,0,e,e,0,0,0,0,f,f,0,0,0,0,g,g,0,0,0,0,h,h,0,0,0,0,i,i,0,0,0,0,j,j,0,0,0,0,k,k,0,0,0,0,0
0,0,0,0,0,b,b,0,0,0,0,c,c,0,0,0,0,d,d,0,0,0,0,e,e,0,0,0,0,f,f,0,0,0,0,g,g,0,0,0,0,h,h,0,0,0,0,i,i,0,0,0,0,j,j,0,0,0,0,k,k,0,0,0,0,0
0,0,0,0,0,b,b,0,0,0,0,c,c,0,0,0,0,d,d,0,0,0,0,e,e,0,0,0,0,f,f,0,0,0,0,g,g,0,0,0,0,h,h,0,0,0,0,i,i,0,0,0,0,j,j,0,0,0,0,k,k,0,0,0,0,0
0,0,0,0,0,b,b,0,0,0,0,c,c,0,0,0,0,d,d,0,0,0,0,e,e,0,0,0,0,f,f,0,0,0,0,g,g,0,0,0,0,h,h,0,0,0,0,i,i,0,0,0,0,j,j,0,0,0,0,k,k,0,0,0,0,0
0,0,0,0,0,b,b,0,0,0,0,c,c,0,0,0,0,d,d,0,0,0,0,e,e,0,0,0,0,f,f,0,0,0,0,g,g,0,0,0,0,h,h,0,0,0,0,i,i,0,0,0,0,j,j,0,0,0,0,k,k,0,0,0,0,0
0,0,0,0,0,*,*,0,0,0,0,0,0,0,0,0,0,0,0,0,0,0,0,*,*,0,0,0,0,0,0,0,0,0,0,0,0,0,0,0,0,*,*,0,0,0,0,0,0,0,0,0,0,0,0,0,0,0,0,*,*,0,0,0,0,0
0,0,0,0,0,*,*,0,0,0,0,0,0,0,0,0,0,0,0,0,0,0,0,*,*,0,0,0,0,0,0,0,0,0,0,0,0,0,0,0,0,*,*,0,0,0,0,0,0,0,0,0,0,0,0,0,0,0,0,*,*,0,0,0,0,0

1,0,0,0,0,0,0,0,0,0,0,0,0,0,0,0,0,0,0,0,0,0,0,0,0,0,0,0,0,0,0,0,0,0,0,0,0,0,0,0,0,0,0,0,0,0,0,0,0,0,0,0,0,0,0,0,0,0,0,0,0,0,0,0,0,1
1,0,0,0,0,0,0,0,0,0,0,0,0,0,0,0,0,0,0,0,0,0,0,0,0,0,0,0,0,0,0,0,0,0,0,0,0,0,0,0,0,0,0,0,0,0,0,0,0,0,0,0,0,0,0,0,0,0,0,0,0,0,0,0,0,1
1,0,0,0,0,0,0,0,0,0,0,0,0,0,0,0,0,0,0,0,0,0,0,0,0,0,0,0,0,0,0,0,0,0,0,0,0,0,0,0,0,0,0,0,0,0,0,0,0,0,0,0,0,0,0,0,0,0,0,0,0,0,0,0,0,1
1,0,0,0,0,0,0,0,0,0,0,0,0,0,0,0,0,0,0,0,0,0,0,0,0,0,0,0,0,0,0,0,0,0,0,0,0,0,0,0,0,0,0,0,0,0,0,0,0,0,0,0,0,0,0,0,0,0,0,0,0,0,0,0,0,1
1,0,0,0,0,0,0,0,0,0,0,0,0,0,0,0,0,0,0,0,0,0,0,0,0,0,0,0,0,0,0,0,0,0,0,0,0,0,0,0,0,0,0,0,0,0,0,0,0,0,0,0,0,0,0,0,0,0,0,0,0,0,0,0,0,1
1,0,0,0,0,0,0,0,0,0,0,0,0,0,0,0,0,0,0,0,0,0,0,0,0,0,0,0,0,0,0,0,0,0,0,0,0,0,0,0,0,0,0,0,0,0,0,0,0,0,0,0,0,0,0,0,0,0,0,0,0,0,0,0,0,1
1,0,0,0,0,0,0,0,0,0,0,0,0,0,0,0,0,0,0,0,0,0,0,0,0,0,0,0,0,0,0,0,0,0,0,0,0,0,0,0,0,0,0,0,0,0,0,0,0,0,0,0,0,0,0,0,0,0,0,0,0,0,0,0,0,1
1,0,0,0,0,0,0,0,0,0,0,0,0,0,0,0,0,0,0,0,0,0,0,0,0,0,0,0,0,0,0,0,0,0,0,0,0,0,0,0,0,0,0,0,0,0,0,0,0,0,0,0,0,0,0,0,0,0,0,0,0,0,0,0,0,1
1,0,0,0,0,0,0,0,0,0,0,0,0,0,0,0,0,0,0,0,0,0,0,0,0,0,0,0,0,0,0,0,0,0,0,0,0,0,0,0,0,0,0,0,0,0,0,0,0,0,0,0,0,0,0,0,0,0,0,0,0,0,0,0,0,1
1,0,0,0,0,0,0,0,0,0,0,0,0,0,0,0,0,0,0,0,0,0,0,0,0,0,0,0,0,0,0,0,0,0,0,0,0,0,0,0,0,0,0,0,0,0,0,0,0,0,0,0,0,0,0,0,0,0,0,0,0,0,0,0,0,1
0,0,0,0,0,0,0,0,0,0,0,0,0,0,0,0,0,0,0,0,0,0,0,0,0,0,0,0,0,0,0,0,0,0,0,0,0,0,0,0,0,0,0,0,0,0,0,0,0,0,0,0,0,0,0,0,0,0,0,0,0,0,0,0,0,0
0,0,0,0,0,0,0,0,0,0,0,0,0,0,0,0,0,0,0,0,0,0,0,0,0,0,0,0,0,0,0,0,0,0,0,0,0,0,0,0,0,0,0,0,0,0,0,0,0,0,0,0,0,0,0,0,0,0,0,0,0,0,0,0,0,0
0,0,0,0,0,0,0,0,0,0,0,0,0,0,0,0,0,0,0,0,0,0,0,0,0,0,0,0,0,0,0,0,0,0,0,0,0,0,0,0,0,0,0,0,0,0,0,0,0,0,0,0,0,0,0,0,0,0,0,0,0,0,0,0,0,0
0,0,0,0,0,0,0,0,0,0,0,0,0,0,0,0,0,0,0,0,0,0,0,0,0,0,0,0,0,0,0,0,0,0,0,0,0,0,0,0,0,0,0,0,0,0,0,0,0,0,0,0,0,0,0,0,0,0,0,0,0,0,0,0,0,0
0,0,0,0,0,0,0,0,0,0,0,0,0,0,0,0,0,0,0,0,0,0,0,0,0,0,0,0,0,0,0,0,0,0,0,0,0,0,0,0,0,0,0,0,0,0,0,0,0,0,0,0,0,0,0,0,0,0,0,0,0,0,0,0,0,0
0,0,0,0,0,0,0,0,0,0,0,0,0,0,0,0,0,0,0,0,0,0,0,0,0,0,0,0,0,0,0,0,0,0,0,0,0,0,0,0,0,0,0,0,0,0,0,0,0,0,0,0,0,0,0,0,0,0,0,0,0,0,0,0,0,0
0,0,0,0,0,0,0,0,0,0,0,0,0,0,0,0,0,0,0,0,0,0,0,0,0,0,0,0,0,0,0,0,0,0,0,0,0,0,0,0,0,0,0,0,0,0,0,0,0,0,0,0,0,0,0,0,0,0,0,0,0,0,0,0,0,0
0,0,0,0,0,0,0,0,0,0,0,0,0,0,0,0,0,0,0,0,0,0,0,0,0,0,0,0,0,0,0,0,0,0,0,0,0,0,0,0,0,0,0,0,0,0,0,0,0,0,0,0,0,0,0,0,0,0,0,0,0,0,0,0,0,0
0,0,0,0,0,0,0,0,0,0,0,0,0,0,0,0,0,0,0,0,0,0,0,0,0,0,0,0,0,0,0,0,0,0,0,0,0,0,0,0,0,0,0,0,0,0,0,0,0,0,0,0,0,0,0,0,0,0,0,0,0,0,0,0,0,0
0,0,0,0,0,0,0,0,0,0,0,0,0,0,0,0,0,0,0,0,0,0,0,0,0,0,0,0,0,0,0,0,0,0,0,0,0,0,0,0,0,0,0,0,0,0,0,0,0,0,0,0,0,0,0,0,0,0,0,0,0,0,0,0,0,0
1,0,0,0,0,0,0,0,0,0,0,0,0,0,0,0,0,0,0,0,0,0,0,0,0,0,0,0,0,0,0,0,0,0,0,0,0,0,0,0,0,0,0,0,0,0,0,0,0,0,0,0,0,0,0,0,0,0,0,0,0,0,0,0,0,1
1,0,0,0,0,0,0,0,0,0,0,0,0,0,0,0,0,0,0,0,0,0,0,0,0,0,0,0,0,0,0,0,0,0,0,0,0,0,0,0,0,0,0,0,0,0,0,0,0,0,0,0,0,0,0,0,0,0,0,0,0,0,0,0,0,1
1,0,0,0,0,0,0,0,0,0,0,0,0,0,0,0,0,0,0,0,0,0,0,0,0,0,0,0,0,0,0,0,0,0,0,0,0,0,0,0,0,0,0,0,0,0,0,0,0,0,0,0,0,0,0,0,0,0,0,0,0,0,0,0,0,1
1,0,0,0,0,0,0,0,0,0,0,0,0,0,0,0,0,0,0,0,0,0,0,0,0,0,0,0,0,0,0,0,0,0,0,0,0,0,0,0,0,0,0,0,0,0,0,0,0,0,0,0,0,0,0,0,0,0,0,0,0,0,0,0,0,1
1,0,0,0,0,0,0,0,0,0,0,0,0,0,0,0,0,0,0,0,0,0,0,0,0,0,0,0,0,0,0,0,0,0,0,0,0,0,0,0,0,0,0,0,0,0,0,0,0,0,0,0,0,0,0,0,0,0,0,0,0,0,0,0,0,1
1,0,0,0,0,0,0,0,0,0,0,0,0,0,0,0,0,0,0,0,0,0,0,0,0,0,0,0,0,0,0,0,0,0,0,0,0,0,0,0,0,0,0,0,0,0,0,0,0,0,0,0,0,0,0,0,0,0,0,0,0,0,0,0,0,1
1,0,0,0,0,0,0,0,0,0,0,0,0,0,0,0,0,0,0,0,0,0,0,0,0,0,0,0,0,0,0,0,0,0,0,0,0,0,0,0,0,0,0,0,0,0,0,0,0,0,0,0,0,0,0,0,0,0,0,0,0,0,0,0,0,1
1,0,0,0,0,0,0,0,0,0,0,0,0,0,0,0,0,0,0,0,0,0,0,0,0,0,0,0,0,0,0,0,0,0,0,0,0,0,0,0,0,0,0,0,0,0,0,0,0,0,0,0,0,0,0,0,0,0,0,0,0,0,0,0,0,1
1,0,0,0,0,0,0,0,0,0,0,0,0,0,0,0,0,0,0,0,0,0,0,0,0,0,0,0,0,0,0,0,0,0,0,0,0,0,0,0,0,0,0,0,0,0,0,0,0,0,0,0,0,0,0,0,0,0,0,0,0,0,0,0,0,1
1,0,0,0,0,0,0,0,0,0,0,0,0,0,0,0,0,0,0,0,0,0,0,0,0,0,0,0,0,0,0,0,0,0,0,0,0,0,0,0,0,0,0,0,0,0,0,0,0,0,0,0,0,0,0,0,0,0,0,0,0,0,0,0,0,1
